key_name	zh_CN
mail_content_activity	活动奖励
mail_content_arena	学员考核奖励
mail_content_boss	紧急任务奖励
mail_content_draw	扭蛋机
mail_content_elite	精英副本
mail_content_endless	模拟训练奖励
mail_content_exploration	探索
mail_content_infinity	模拟训练
mail_content_intimate	亲密度
mail_content_nomal	普通副本
mail_content_arena_daily	学员考核每日排名奖励
mail_content_arena_fighting	学员考核战斗结算
mail_content_arena_worship	学员考核膜拜奖励
mail_content_resource	补给任务
mail_content_sign	签到
mail_content_simulation_train	作战演习奖励
mail_content_task	任务
mail_content_tower	能力评估奖励
mail_content_vip	特权达成奖励
mail_sender_name	观月老师
mail_title_activity	活动奖励
mail_title_arena	学员考核奖励
mail_title_boss	紧急任务
mail_title_draw	扭蛋机
mail_title_elite	精英副本
mail_title_endless	模拟训练排名奖励
mail_title_exploration	探索
mail_title_infinity	模拟训练排名奖励
mail_title_intimate	亲密度
mail_title_nomal	普通副本
mail_title_arena_daily	学员考核每日排名奖励
mail_title_arena_fighting	学员考核战斗结算
mail_title_arena_worship	学员考核膜拜奖励
mail_title_resource	补给任务
mail_title_sign	签到
mail_title_simulation_train	作战演习奖励
mail_title_task	任务
mail_title_tower	能力评估奖励
mail_title_vip	特权达成奖励
mail_title_store	商店
mail_content_store	商店奖励
mail_title_pvp	荣誉商店标题
mail_content_pvp	荣誉商店内容
